0,0,0,0,0,0,0,0,0,0,0,0,0,0,0,0,0,0,0,0,0,0,0,0,0,0,0,0,0,0,0,0,0,0,0,0,0,0,0,0,0,0,0,0,0,0,0,0,0,0,0,0,0,0,0,0,0,0,0,0,0,0,0,0,0,0,0,0,0,0,0,0,0,0,0,0,0,0,0,0,0,0,0,0,0,0,0,0,0,0,0,0,0,0,0,0,0,0,0,0,0,0,0,0,0,0,0,0,0,0,0,0,0,0,0,0,0,0,0,0,0,0,0,0,0,0,0,0,0,0,0,0,0,0,0,0,0,0,0,0,0,0,0,0,0,0,0,0,0,0,0,0,0,0,0,0,0,0,0,0,0,0,0,0,0,0,0,0,0,0,0,0,0,0,0,0,0,0,0,0,0,0,0,0,0,0,0,0,0,0,0,0,0,0,144,130,113,129,145,129,145,129,147,147,145,145,146,145,129,147,130,130,148,0,0,0,0,0,0,0,130,145,145,145,147,130,130,145,129,129,130,146,129,129,145,131,131,147,129,147,146,130,130,145,146,129,147,131,145,130,145,147,146,145,145,131,147,130,147,129,129,131,129,145,131,130,147,147,129,131,146,147,130,146,130,131,146,145,131,146
0,0,0,0,0,0,0,0,0,0,0,0,0,0,0,0,0,0,0,0,0,0,0,0,0,0,0,0,0,0,0,0,0,0,0,0,0,0,0,0,0,0,0,0,0,0,0,0,0,0,0,0,0,0,0,0,0,0,0,0,0,0,0,0,0,0,0,0,0,0,0,0,0,0,0,0,0,0,0,0,0,0,0,0,0,0,0,0,0,0,0,0,0,0,0,0,0,0,0,0,0,0,0,0,0,0,0,0,0,0,0,0,0,0,0,0,0,0,0,0,0,0,0,0,0,0,0,0,0,0,0,0,0,0,0,0,0,0,0,0,0,0,0,0,0,0,0,0,0,0,0,0,0,0,0,0,0,0,0,0,0,0,0,0,0,0,0,0,0,0,0,0,0,0,0,0,0,0,0,0,0,0,0,0,0,0,0,0,0,0,0,0,0,0,160,128,129,129,161,145,131,147,146,147,147,129,131,131,131,146,146,145,164,0,0,0,0,0,0,0,160,147,130,147,147,131,131,130,145,145,131,130,146,129,147,130,146,129,130,130,146,146,129,145,130,147,145,145,147,129,147,146,146,130,147,129,131,147,145,147,147,131,131,147,147,130,130,130,131,131,146,130,131,131,146,130,146,129,129,130
0,0,0,0,0,0,0,0,0,0,0,0,0,0,0,0,0,0,0,0,0,0,0,0,0,0,0,0,0,0,0,0,0,0,0,0,0,0,0,0,0,0,0,0,0,0,0,0,0,0,0,0,0,0,0,0,0,0,0,0,0,0,0,0,0,0,0,0,0,0,0,0,0,0,0,0,0,0,0,0,0,0,0,0,0,0,0,0,0,0,0,0,0,0,0,0,0,0,0,0,0,0,0,0,0,0,0,0,0,0,0,0,0,0,0,0,0,0,0,0,0,0,0,0,0,0,0,0,0,0,0,0,0,0,0,0,0,0,0,0,0,0,0,0,0,0,0,0,0,0,0,0,0,0,0,0,0,0,0,0,0,0,0,0,0,0,0,0,0,0,0,0,0,0,0,0,0,0,0,0,0,0,0,0,0,0,0,0,0,0,0,0,0,0,0,144,145,161,129,161,131,129,145,146,130,145,131,130,145,129,145,147,26,0,0,0,0,0,0,0,0,160,131,147,145,130,147,130,130,145,147,130,145,131,129,145,129,145,129,146,130,146,131,146,130,145,145,146,145,145,130,130,147,129,129,131,130,146,130,147,147,131,146,130,147,147,147,147,130,145,146,130,129,147,146,130,146,147,146,146
0,0,0,0,0,0,0,0,0,0,0,0,0,0,0,0,0,0,0,0,0,0,0,0,0,0,0,0,0,0,0,0,0,0,0,0,0,0,0,0,0,0,0,0,0,0,0,0,0,0,0,0,0,0,0,0,0,0,0,0,0,0,0,0,0,0,0,0,0,0,0,0,0,0,0,0,0,0,0,0,0,0,0,0,0,0,0,0,0,0,0,0,0,0,0,0,0,0,0,0,0,0,0,0,0,0,0,0,0,0,0,0,0,0,0,0,0,0,0,0,0,0,0,0,0,0,0,227,0,0,0,0,0,0,0,0,0,0,0,0,0,0,0,0,0,0,0,0,0,0,0,0,0,0,0,0,0,0,0,0,0,0,0,0,0,0,0,0,227,0,0,0,0,0,0,0,0,0,0,0,0,0,0,0,0,0,0,0,0,0,0,0,0,0,0,160,128,161,129,129,131,129,129,131,129,130,145,130,129,129,147,164,0,0,0,0,0,0,0,0,0,0,160,162,163,161,162,163,161,162,161,162,163,161,161,162,161,162,163,161,130,130,145,129,130,130,131,146,146,131,147,129,129,131,146,130,146,146,131,129,145,129,146,131,145,145,147,129,131,129,130,145,129,131,145,129,145,130,131,129
0,0,0,0,0,0,0,0,0,0,0,0,0,0,0,0,0,0,0,0,0,0,0,0,0,0,0,0,0,0,0,0,0,0,0,0,0,0,0,0,0,0,0,0,0,0,0,0,0,0,0,0,0,0,0,0,0,0,0,0,0,0,0,0,0,0,0,0,0,0,0,0,0,0,0,0,0,0,0,0,0,0,0,0,0,0,0,0,0,0,0,0,0,0,0,0,0,0,0,0,0,0,0,0,0,0,0,0,0,0,0,0,0,0,0,0,0,0,0,0,0,0,0,0,0,0,0,0,0,0,0,0,0,0,0,0,0,0,0,0,0,0,0,0,0,0,0,0,0,0,0,0,0,0,0,0,0,0,0,0,0,0,0,0,0,0,0,0,0,0,0,0,0,0,0,0,0,0,0,0,0,0,0,0,0,0,0,0,0,0,0,0,0,0,0,0,144,129,129,145,147,145,147,131,129,131,145,146,162,163,164,0,0,0,0,0,0,0,0,0,0,0,0,160,161,162,163,146,147,146,146,130,129,129,130,131,147,131,129,130,131,130,131,145,145,147,130,129,129,146,129,147,145,131,146,130,131,131,131,145,147,145,145,129,129,129,147,131,130,129,130,147,146,130,130,130,130,147,131,130
0,0,0,0,0,0,0,0,0,0,0,0,0,0,0,0,0,0,0,0,0,0,0,0,0,0,0,0,0,0,0,0,0,0,0,0,0,0,0,0,0,0,0,0,0,0,0,0,0,0,0,0,0,0,0,0,0,0,0,0,0,0,0,0,0,0,0,0,0,0,0,0,0,0,0,0,0,0,0,0,0,0,0,0,0,0,0,0,0,0,0,0,0,0,0,0,0,0,0,0,0,0,0,0,0,0,0,0,0,0,0,0,0,0,0,0,0,0,0,0,0,0,0,0,0,0,0,0,0,0,0,0,0,0,0,0,0,0,0,0,0,0,0,0,0,0,0,0,0,0,0,0,0,0,0,0,0,0,0,0,0,0,0,0,0,0,0,0,0,0,0,0,0,0,0,0,0,0,0,0,0,0,0,0,0,0,0,0,0,0,0,0,0,0,0,0,160,161,145,161,146,129,145,130,129,162,163,164,0,10,0,0,0,0,0,0,0,0,0,0,0,0,0,0,0,0,0,160,161,162,163,146,130,130,131,130,145,145,147,131,131,147,131,130,131,131,130,146,129,147,129,129,145,129,130,145,147,130,146,147,145,130,147,130,129,130,131,131,130,131,146,145,131,130,130,131,146,131,130,145
0,0,0,0,0,0,0,0,0,0,0,0,0,0,0,0,0,0,0,0,0,0,0,0,0,0,0,0,0,0,0,0,0,0,0,0,0,0,0,0,0,0,0,0,0,0,0,0,0,0,0,0,0,0,0,0,0,0,0,0,0,0,0,0,0,0,0,0,0,0,0,0,0,0,0,0,0,0,0,0,0,0,0,0,0,0,0,0,0,0,0,0,0,0,0,0,0,0,0,0,0,0,0,0,0,0,0,0,0,0,0,0,0,0,0,1,2,0,0,0,0,0,0,0,0,0,0,0,0,182,183,0,0,0,0,0,0,0,0,0,0,0,0,0,0,0,0,0,0,0,0,0,0,184,185,0,0,0,0,0,0,0,0,0,0,0,0,0,0,0,0,0,0,0,0,0,0,0,0,0,0,0,0,0,0,0,0,0,0,0,0,0,0,0,0,0,0,160,145,145,147,131,146,131,162,163,164,0,0,0,0,0,0,0,0,0,0,0,0,0,0,0,0,0,0,0,0,58,59,160,161,162,163,131,146,129,130,145,145,129,147,131,129,130,129,145,147,131,145,131,146,129,129,147,129,146,131,145,130,145,145,131,130,129,146,131,146,146,145,129,131,147,145,129,145,146,130,146,146,129
0,0,0,0,0,0,0,0,0,0,0,0,0,0,0,0,0,0,0,0,0,0,0,0,0,0,0,0,0,0,0,0,0,0,0,0,0,0,0,0,0,0,0,0,0,0,0,0,0,0,0,0,0,0,0,0,0,0,0,0,0,0,0,0,0,0,0,0,0,0,0,0,0,0,0,0,0,0,0,0,0,0,0,0,0,0,0,0,0,0,0,0,0,0,0,0,0,0,0,0,0,0,0,0,0,0,0,0,0,0,0,0,0,0,0,17,18,96,97,98,99,97,98,100,0,0,0,0,0,198,199,0,1,2,0,0,0,0,0,0,1,2,0,0,0,0,0,0,0,0,0,0,0,200,201,0,1,2,0,0,0,0,0,0,0,0,0,0,0,0,0,0,0,0,0,0,0,0,0,0,0,0,0,0,0,0,0,0,0,0,0,0,0,0,0,0,0,10,160,146,146,146,162,163,164,0,10,0,0,0,0,0,0,0,0,0,0,0,0,0,0,0,0,0,0,0,0,0,0,0,0,0,0,160,161,162,163,161,162,163,131,131,146,131,130,129,131,130,146,129,147,145,145,145,129,131,129,146,129,145,147,131,129,131,147,145,147,146,145,129,130,147,131,131,145,145,145,146,147,130
0,0,0,0,0,0,0,0,0,0,0,0,0,0,0,0,0,0,0,0,0,0,0,0,0,0,0,0,0,0,0,0,0,0,0,0,0,184,185,0,0,184,185,0,0,0,0,0,0,182,183,0,0,0,0,0,0,0,0,0,0,0,0,0,0,0,0,0,0,0,0,0,0,0,0,0,0,0,0,0,0,0,0,0,0,0,0,0,0,0,0,0,0,0,0,0,0,0,0,0,0,0,0,0,0,0,0,0,0,0,0,0,0,0,0,33,34,160,113,114,115,113,114,164,0,0,0,0,96,97,98,100,17,18,7,8,9,7,8,9,17,18,96,100,0,0,0,96,100,0,0,0,96,97,98,100,17,18,0,0,0,0,0,0,0,0,0,0,0,0,0,0,0,0,0,0,1,2,0,0,1,2,0,0,0,0,0,0,0,0,0,0,0,0,0,0,0,0,26,160,162,163,164,0,42,0,0,0,0,0,0,0,0,0,0,0,0,0,0,0,0,0,0,0,0,0,0,0,0,0,0,0,0,0,0,0,0,160,145,146,161,162,163,161,162,163,161,162,163,161,162,163,161,162,163,161,162,163,161,162,163,161,162,163,161,162,163,161,162,163,161,162,163,161,162,163,161,162,163,161
0,0,0,0,0,0,0,0,0,0,0,0,0,0,0,0,0,0,1,2,0,0,0,0,0,0,0,0,0,0,0,0,0,0,0,0,0,200,201,0,0,200,201,0,0,0,0,0,0,198,199,0,1,2,0,0,0,0,0,0,0,1,2,0,0,0,0,0,0,0,0,0,0,0,0,0,0,0,0,0,0,0,0,0,0,0,0,0,0,0,0,0,0,0,0,0,0,0,0,0,0,0,0,0,0,0,0,0,0,0,0,0,0,0,1,2,0,0,0,0,0,0,0,0,0,0,0,0,112,113,114,116,17,18,96,97,98,99,99,100,17,18,160,164,0,0,0,160,164,0,0,0,112,113,163,164,17,18,0,0,0,0,0,0,0,0,0,0,0,0,0,0,0,0,0,0,17,18,96,100,17,18,0,0,0,96,97,100,0,0,0,0,0,0,0,0,0,0,0,11,12,13,15,0,0,0,0,0,0,0,0,0,0,0,0,0,0,0,0,0,0,0,0,0,0,0,0,0,0,0,0,0,0,0,0,0,0,0,58,59,10,10,26,11,12,15,58,59,58,59,58,59,0,0,0,0,58,59,58,59,58,59,58,59,0,0,0,0,58,59,58,59,58,59,11,14,15,26,10,10
0,0,0,0,0,0,0,0,0,0,0,0,0,0,0,0,0,0,17,18,96,99,100,0,0,96,97,100,0,0,96,97,100,0,0,0,96,97,98,99,97,98,99,100,0,0,0,96,97,98,99,100,17,18,96,100,11,15,96,99,100,17,18,0,0,0,0,0,0,0,0,0,0,0,0,0,0,0,0,0,0,0,0,0,0,0,0,0,0,0,0,0,0,0,0,0,0,0,0,0,0,0,0,0,0,0,0,0,0,0,0,0,0,0,17,18,0,0,0,0,0,0,0,0,0,0,0,0,144,147,161,161,17,18,112,113,114,163,163,164,17,18,0,0,0,0,0,0,0,0,0,0,128,116,10,42,17,18,0,0,0,0,0,0,0,0,0,1,2,0,0,0,0,0,0,0,17,18,112,116,17,18,0,0,0,112,113,116,0,0,0,0,0,0,214,215,0,0,0,27,28,29,31,0,0,0,0,0,0,0,0,0,0,0,0,0,0,0,0,0,0,0,0,0,0,0,0,0,0,0,0,0,0,0,0,0,0,0,0,0,0,0,0,27,28,31,0,0,0,0,0,0,0,0,0,0,0,0,0,0,0,0,0,0,0,0,0,0,0,0,0,0,0,0,27,30,31,0,0,0
0,0,0,0,0,0,0,0,0,0,0,0,0,0,0,0,0,0,17,18,112,115,116,0,0,112,113,116,0,0,112,113,116,0,0,0,112,113,114,115,113,114,115,116,0,0,0,112,130,114,130,132,17,18,112,116,27,31,112,115,116,17,18,0,0,0,0,0,0,0,0,0,0,0,0,0,0,0,0,0,0,0,0,0,0,0,0,0,0,0,0,0,0,0,0,0,0,0,0,0,0,0,1,2,0,0,0,0,0,0,0,0,0,0,33,34,0,0,0,0,0,0,0,0,0,0,0,0,128,145,163,129,17,18,26,10,0,0,42,26,17,18,0,0,0,0,0,0,0,0,0,0,144,132,0,0,17,18,0,0,0,0,0,0,0,0,0,17,18,96,97,98,100,0,0,0,33,34,128,129,17,18,0,0,0,128,162,132,0,0,0,1,2,0,230,231,0,0,0,43,44,45,47,0,0,0,0,0,0,0,0,0,0,0,0,0,0,0,0,0,0,0,0,0,0,0,0,0,0,0,0,0,0,0,0,0,0,0,0,0,0,0,0,19,28,31,0,0,0,0,0,184,185,0,0,0,0,0,0,0,0,0,0,0,0,0,0,182,183,0,0,0,0,0,27,28,22,0,0,0
0,0,0,0,0,0,0,0,0,0,0,0,0,0,0,0,0,0,17,18,145,145,132,0,0,131,163,132,0,0,128,131,132,0,0,0,160,161,163,145,144,161,162,164,0,0,0,160,161,162,147,164,17,18,160,164,43,47,128,129,146,17,18,0,0,0,0,0,0,0,0,0,0,0,0,0,0,0,0,0,0,0,0,0,0,0,0,0,0,0,0,0,0,0,96,100,0,0,0,96,99,100,17,18,96,100,0,0,0,96,100,0,0,1,2,0,0,0,0,0,0,0,0,0,0,0,0,0,144,145,129,162,17,18,0,0,0,0,0,0,17,18,0,0,0,0,0,0,0,0,0,0,112,148,0,0,17,18,0,0,0,0,0,0,0,0,0,17,18,160,113,114,164,0,0,0,0,0,144,145,17,18,0,0,0,160,161,164,0,0,0,17,18,96,97,98,99,97,98,99,97,98,99,104,0,0,0,0,0,0,0,0,0,0,0,0,0,0,0,0,0,0,0,0,0,0,0,0,0,0,0,0,0,0,0,0,0,0,0,0,0,0,0,27,30,31,0,0,0,1,2,200,201,0,0,0,0,0,0,0,0,0,0,0,0,0,0,198,199,1,2,0,0,0,19,28,22,0,0,0
0,0,0,0,0,0,0,0,0,0,0,0,0,0,0,0,0,0,33,34,129,131,148,24,25,147,162,131,24,25,144,146,148,0,0,0,11,15,26,10,26,42,11,15,0,0,0,3,12,15,42,26,20,18,10,42,0,0,144,145,161,17,18,0,0,0,0,0,0,0,184,185,0,0,0,0,0,0,0,0,0,0,0,0,0,0,0,0,0,0,96,100,0,0,160,164,0,0,0,112,130,116,17,18,112,116,7,8,9,112,116,0,0,17,18,0,0,0,0,0,0,0,0,0,0,0,0,0,128,146,145,147,17,18,0,0,0,0,0,0,17,18,0,0,0,0,0,0,0,0,0,0,160,164,1,2,33,34,0,0,0,0,0,0,0,0,0,17,18,0,0,0,0,0,0,0,0,0,144,129,17,18,0,0,0,0,10,0,0,0,0,17,18,112,113,161,161,145,145,145,113,114,115,120,98,99,104,0,0,0,0,0,0,0,0,0,0,0,0,0,0,0,0,0,0,0,0,0,0,0,0,0,0,0,0,0,0,0,0,0,0,0,0,19,29,31,0,0,0,17,18,96,100,0,0,248,249,249,249,249,249,249,249,249,250,0,0,96,100,17,18,0,0,0,19,30,22,0,0,0
0,0,0,0,0,0,0,0,0,0,0,0,0,0,101,102,97,98,99,117,129,145,131,40,41,163,163,147,40,41,112,146,116,0,0,0,27,31,0,0,0,0,19,31,0,0,0,19,28,31,0,0,17,18,0,0,0,0,128,129,131,17,18,0,0,0,0,0,0,0,200,201,0,0,0,96,97,98,99,97,98,99,100,0,0,0,96,100,0,0,160,164,0,0,0,0,0,0,0,129,129,146,17,18,147,120,121,98,117,118,131,0,0,33,34,0,0,0,0,0,0,0,0,0,0,0,0,0,144,161,146,146,33,34,0,0,0,0,0,0,33,34,0,0,0,0,0,0,0,0,0,0,11,15,17,18,96,97,98,97,98,97,98,100,0,0,0,33,34,0,0,0,0,0,0,0,0,0,128,161,17,18,0,0,0,0,0,0,0,0,0,17,18,161,69,70,71,72,129,145,146,147,145,136,114,115,120,99,104,0,0,0,0,0,0,0,0,0,0,0,0,0,0,0,0,0,0,0,0,0,0,0,0,0,0,0,0,0,0,0,0,0,0,27,30,31,0,0,0,17,18,160,164,0,0,11,6,0,0,0,0,0,0,11,15,0,0,160,164,17,18,0,0,0,19,28,22,0,0,0
0,0,64,65,66,67,68,0,214,215,0,0,101,102,117,118,113,114,115,162,161,162,163,161,145,147,161,146,163,146,161,145,132,184,185,0,19,31,0,0,0,0,27,31,0,0,0,19,29,31,0,0,17,18,0,0,0,0,144,145,131,17,18,0,0,0,0,11,15,96,98,99,100,11,15,112,113,114,115,113,114,115,116,0,0,0,160,164,0,0,0,0,0,0,0,0,0,0,0,128,131,146,17,18,160,136,137,114,133,134,164,0,1,2,0,0,0,0,0,0,0,0,0,0,0,0,0,0,144,129,131,120,121,98,99,100,0,0,96,97,98,99,97,100,0,0,0,0,0,0,0,0,27,31,17,18,160,113,114,113,114,113,114,164,0,0,0,0,0,0,0,0,0,0,0,0,0,0,128,145,17,18,0,0,0,0,0,0,0,0,0,17,18,161,85,86,87,88,145,145,146,131,131,145,130,146,136,115,120,104,0,0,0,0,0,0,0,0,0,0,0,0,0,0,0,0,0,0,0,0,0,0,0,0,0,0,0,0,0,0,0,0,0,19,30,31,0,0,0,17,18,0,0,0,0,27,22,0,0,0,0,0,0,27,31,0,0,0,0,17,18,0,0,0,27,29,31,0,0,0
0,0,80,81,82,83,84,0,230,231,101,102,117,118,129,130,145,163,162,145,162,162,146,147,145,146,146,162,163,146,145,146,148,200,201,0,43,47,0,0,0,0,43,47,0,0,0,35,44,47,0,0,33,34,0,0,0,0,144,161,161,33,34,0,0,102,100,43,47,112,114,115,116,43,47,144,147,161,147,130,147,163,161,0,0,0,0,0,0,0,0,0,0,0,0,0,0,0,0,128,161,131,17,18,0,182,183,0,0,184,185,0,17,18,0,0,0,0,96,97,98,99,98,100,24,25,96,117,118,146,147,136,137,114,115,116,24,25,112,113,114,115,113,116,24,25,24,25,24,25,24,25,19,31,17,18,0,0,0,0,0,214,215,0,0,0,0,0,0,0,0,0,0,0,0,0,0,0,128,161,33,34,0,0,0,0,0,0,0,0,0,33,34,161,161,161,145,161,129,129,147,147,130,129,131,130,146,147,136,120,104,0,0,0,0,0,0,0,0,0,0,0,0,0,0,0,0,0,0,0,0,0,0,0,0,0,0,0,0,0,0,0,0,27,28,31,0,0,0,17,18,0,0,0,0,19,31,0,0,214,215,0,0,19,22,0,0,0,0,17,18,0,0,0,19,28,31,0,0,0
97,98,99,97,98,99,97,98,97,98,117,118,130,116,129,130,69,70,71,72,161,161,161,147,162,163,146,163,145,161,146,146,120,121,97,98,99,97,98,99,97,98,99,97,98,99,97,98,99,97,98,99,97,98,99,97,98,117,118,145,120,121,97,98,97,118,116,0,0,0,0,0,0,0,0,128,162,147,145,161,129,129,132,0,0,0,0,0,0,0,0,0,0,0,0,0,0,0,0,128,145,129,33,34,0,198,199,0,0,200,201,0,33,34,0,7,8,9,112,113,114,115,114,116,40,41,112,133,134,73,74,75,76,147,129,116,40,41,146,162,146,162,146,162,40,41,40,41,40,41,40,41,43,47,33,34,0,0,0,0,0,230,231,0,0,0,0,0,0,0,0,0,0,0,0,0,0,0,128,120,121,99,100,24,25,96,99,100,24,25,96,97,117,118,129,145,145,129,161,161,129,129,145,146,131,147,130,147,130,136,120,104,0,0,0,0,0,0,96,100,0,0,0,0,0,0,0,56,57,0,0,0,56,57,0,0,0,0,0,0,0,0,0,43,44,47,0,0,0,33,34,0,0,0,0,43,47,0,0,230,231,0,0,35,47,0,0,0,0,33,34,0,0,0,43,46,47,0,0,0
113,114,115,113,114,115,113,114,113,114,115,145,161,145,145,145,85,86,87,88,146,162,145,145,163,161,131,69,70,71,72,145,146,147,113,114,115,113,114,115,113,114,115,113,114,115,113,114,115,113,114,115,113,114,115,113,114,115,130,162,145,146,113,114,113,163,161,0,0,0,0,0,0,0,0,128,131,129,161,161,129,130,148,0,0,0,0,0,0,0,0,0,0,0,0,0,0,0,0,128,129,120,121,97,98,99,97,98,99,97,98,99,97,98,99,97,98,117,118,161,162,161,129,145,146,113,145,130,130,89,90,91,92,129,161,145,113,113,147,69,70,71,72,120,121,97,98,99,97,98,99,97,98,99,97,98,99,97,98,99,97,98,99,100,0,0,0,0,0,0,0,0,0,0,0,0,0,0,128,136,137,115,116,40,41,112,115,116,40,41,112,113,133,134,161,73,74,75,76,161,146,129,147,69,70,71,72,130,145,145,136,120,98,99,100,0,0,0,112,116,0,0,0,96,97,98,99,97,98,99,97,98,99,97,98,99,97,98,99,97,97,98,99,97,98,99,97,98,99,97,98,99,97,98,99,97,98,99,97,98,99,97,98,99,97,98,97,98,99,97,98,99,97,98,99,98,99,97,98,99
161,162,73,74,75,76,161,161,131,162,163,145,145,146,131,131,163,146,146,131,145,163,146,145,163,131,161,85,86,87,88,161,162,163,131,145,163,147,145,145,147,161,69,70,71,72,161,161,163,131,163,162,162,145,163,131,146,163,161,163,163,73,74,75,76,130,148,0,0,0,0,0,0,0,0,128,145,145,162,131,145,147,132,0,0,0,0,0,0,0,0,0,0,0,0,0,0,0,0,128,163,136,137,113,114,115,113,114,115,113,114,115,113,114,115,113,114,133,134,73,74,75,76,136,137,133,147,146,131,145,163,163,146,163,129,136,137,133,146,85,86,87,88,136,137,113,114,115,113,114,115,113,114,115,113,114,115,113,114,115,113,114,115,116,0,0,0,0,0,0,0,0,0,0,0,0,0,0,144,129,145,129,145,161,145,129,146,145,145,129,145,161,161,145,129,89,90,91,92,145,130,130,129,85,86,87,88,129,129,130,131,136,114,115,116,0,0,0,128,132,0,0,0,112,113,114,115,113,114,115,113,114,115,113,114,115,113,114,115,113,129,130,131,129,130,131,129,130,131,129,130,131,129,130,131,129,130,131,129,130,131,129,130,131,129,130,131,129,130,131,129,130,131,129,130,131,129,130,131,129
145,146,89,90,91,92,145,131,145,163,162,145,131,131,131,145,163,131,145,162,145,163,162,146,162,146,162,146,146,147,162,146,145,146,147,130,163,161,145,146,162,146,85,86,87,88,146,146,162,145,146,146,162,145,162,131,131,145,145,162,146,89,90,91,92,130,146,240,241,242,243,240,241,242,243,163,129,129,163,129,161,162,161,240,241,242,243,240,241,242,243,240,241,242,243,240,241,242,243,163,162,129,162,161,130,129,130,129,129,162,162,146,147,129,146,130,129,161,130,89,90,91,92,145,129,130,129,147,162,130,130,161,146,131,131,163,145,162,147,161,147,145,145,163,145,147,145,162,145,146,161,147,145,147,161,161,161,129,129,161,145,161,129,161,240,241,242,243,240,241,242,243,240,241,242,243,240,241,161,161,161,161,161,129,161,145,145,145,161,145,161,161,161,161,145,145,161,145,129,129,129,131,130,146,129,147,131,131,130,129,147,131,145,145,132,240,241,242,144,148,241,242,243,128,129,130,131,129,161,129,129,161,130,147,162,145,130,129,130,161,145,146,147,145,146,147,145,146,147,145,146,147,145,146,147,145,146,147,145,146,147,145,146,147,145,146,147,145,146,147,145,146,147,145,146,147,145,146,147,145
145,131,161,145,162,162,145,131,145,145,163,145,131,145,145,162,162,131,131,162,145,145,145,145,146,146,146,145,163,163,161,162,161,162,163,130,162,146,162,147,163,162,146,162,161,161,145,145,163,131,131,146,145,162,145,163,163,146,162,145,163,163,163,163,145,130,161,244,245,246,247,244,245,246,247,163,145,130,147,145,130,161,162,244,245,246,247,244,245,246,247,244,245,246,247,244,245,246,247,129,130,131,145,131,129,163,162,145,161,145,145,161,145,162,129,129,162,130,130,163,147,161,162,146,163,129,163,129,163,129,161,161,146,163,147,131,161,162,147,145,146,147,147,145,147,145,162,147,146,146,147,162,163,145,129,145,129,145,161,129,129,129,129,129,244,245,246,247,244,245,246,247,244,245,246,247,244,245,161,129,161,161,145,161,129,129,161,145,129,161,161,129,146,130,161,145,145,145,161,145,147,129,146,145,145,145,147,147,129,146,129,129,147,146,148,244,245,246,247,244,245,246,247,144,145,146,147,162,146,146,162,129,131,162,161,163,147,145,129,163,129,130,131,129,130,131,129,130,131,129,130,131,129,130,131,129,130,131,129,130,131,129,130,131,129,130,131,129,130,131,129,130,131,129,130,131,129,130,131,129
