96,97,98,99,100,101,102,103,97,98,99,100,99,100,97,98,99,100,101,102,97,98,99,97,98,99,100,97,98,99,100,101,98,99,97,98,99,100,101,103
112,113,114,115,116,117,118,119,113,114,115,116,115,116,113,114,115,116,117,118,113,114,115,113,114,115,116,113,114,115,116,117,119,112,113,114,115,116,117,118
159,129,16,2,2,128,129,1,2,129,18,19,18,19,16,17,129,17,16,17,128,129,18,19,19,129,18,19,128,129,18,19,0,1,2,0,1,2,2,140
175,0,21,2,3,0,1,2,3,0,1,2,3,0,1,2,3,0,1,2,3,0,1,2,3,0,1,2,3,0,1,2,16,17,18,16,17,18,18,156
159,21,240,21,19,16,17,18,19,16,17,18,19,16,17,18,19,16,17,18,19,16,17,18,19,16,17,18,19,16,17,18,0,1,2,0,0,1,2,172
159,13,9,12,14,15,12,11,9,13,15,13,104,105,9,32,33,15,9,13,9,11,32,33,15,15,106,107,15,10,18,19,16,0,1,2,2,17,18,156
175,109,110,111,108,109,110,111,108,109,110,111,120,121,108,32,33,111,108,109,110,111,32,33,110,111,122,123,108,109,110,111,11,10,0,0,32,33,2,172
159,0,1,2,3,0,1,2,3,0,1,2,3,0,1,32,33,0,1,2,3,0,32,33,2,3,19,19,124,125,126,127,108,109,110,111,32,33,2,156
159,16,17,18,19,16,17,18,19,16,17,18,19,16,17,32,33,16,17,18,19,16,32,33,18,19,2,3,0,1,2,3,124,125,126,127,32,33,18,172
175,0,16,0,2,3,1,2,3,0,1,0,1,1,2,32,33,2,3,3,0,1,32,33,2,16,2,3,16,17,18,19,0,0,0,1,36,33,2,156
159,36,37,17,18,19,17,18,19,32,33,16,17,17,18,32,33,18,19,19,16,17,32,33,18,19,18,19,16,17,2,3,5,6,16,17,34,35,18,172
175,36,37,138,139,21,24,138,139,32,33,110,20,21,20,111,108,109,110,111,108,109,110,111,21,21,21,22,23,24,23,24,6,5,7,7,34,35,5,156
159,36,37,154,155,23,24,154,155,32,33,126,20,21,4,127,124,125,126,127,124,125,126,127,104,105,23,23,22,23,6,20,32,33,6,21,34,35,5,172
175,34,33,24,24,24,4,24,24,32,33,6,24,24,6,24,22,24,20,24,5,24,4,24,120,121,104,105,21,21,104,105,32,33,7,5,32,37,24,156
24,34,33,24,4,24,4,24,6,32,33,24,24,24,24,24,24,22,24,4,24,20,24,4,24,24,120,121,23,4,120,121,32,33,21,5,32,37,24,172
23,32,33,23,24,4,24,23,24,32,33,4,6,24,4,22,24,24,24,24,24,24,24,6,24,22,24,24,21,20,23,24,32,33,22,5,32,37,4,156
24,32,33,24,24,24,24,24,24,32,33,24,24,138,139,24,24,23,24,20,24,5,22,24,24,24,24,4,22,24,24,4,32,33,12,13,32,33,14,172
140,141,142,143,243,243,243,243,140,141,142,142,243,243,243,243,140,141,142,143,241,241,241,241,140,141,142,143,241,241,241,241,140,141,141,142,141,142,143,156
156,157,158,159,52,53,54,55,156,157,158,158,52,53,54,55,156,157,158,159,68,68,68,68,156,157,158,159,68,68,68,68,156,157,157,158,157,158,159,172
172,173,174,175,56,56,56,56,172,173,174,174,56,56,56,56,172,173,174,175,68,68,68,68,172,173,174,175,68,68,68,68,172,173,173,174,173,174,175,156
188,189,190,191,56,56,56,56,188,189,190,190,56,56,56,56,188,189,190,191,242,242,242,242,188,189,190,191,242,242,242,242,188,189,189,190,189,190,191,172
144,145,146,147,148,149,150,146,147,148,149,150,146,147,148,148,149,150,146,147,148,149,150,146,147,148,146,147,148,149,150,149,166,146,147,148,149,150,150,173
160,161,162,163,164,165,166,162,163,164,165,166,177,178,179,180,182,182,162,163,164,165,166,181,182,182,162,163,164,165,166,165,166,162,163,164,165,166,166,167
