96,81,82,83,84,85,86,81,82,83,84,85,86,81,82,83,84,85,86,81,82,83,84,85,86,81,82,83,84,85,86,81,82,83,84,85,86,81,82,87
96,97,98,99,100,101,102,97,98,99,100,101,102,97,98,99,100,101,102,97,98,99,100,101,102,97,98,99,100,101,102,97,98,99,100,101,102,97,98,87
154,155,112,113,2,2,5,3,1,0,2,112,113,5,7,112,113,5,3,4,6,3,7,0,3,7,6,4,112,113,6,2,6,0,2,7,5,112,113,1
170,171,5,1,5,4,5,5,4,6,3,6,7,1,6,4,3,6,6,6,5,1,4,2,2,1,3,4,2,7,1,6,0,7,5,6,5,5,7,2
152,153,3,4,7,1,0,3,1,2,0,4,3,6,1,0,2,2,1,2,6,1,3,1,6,4,2,4,5,5,7,7,7,4,4,0,2,1,1,3
154,155,3,2,1,1,6,5,6,0,7,5,0,5,5,4,4,4,3,6,1,1,2,1,2,6,3,3,6,4,0,0,4,6,1,2,4,2,2,4
170,171,3,6,3,4,6,4,4,1,3,0,7,1,6,3,6,7,1,5,5,0,6,1,2,6,2,0,6,1,5,7,6,4,2,3,0,4,4,2
90,91,1,5,1,1,1,92,93,94,95,7,6,92,93,94,95,0,4,92,93,94,95,6,5,92,93,94,95,1,7,92,93,94,95,92,93,94,16,17
106,107,6,2,3,152,153,108,109,110,111,5,2,108,109,110,111,0,7,108,109,110,111,0,5,108,109,110,111,2,0,108,109,110,111,108,109,110,16,17
88,89,16,17,152,153,3,2,3,3,3,2,3,1,0,0,5,7,2,0,3,0,4,0,6,5,3,7,2,7,1,4,1,3,5,6,2,0,16,17
104,105,16,19,7,2,2,7,6,6,7,5,3,7,3,6,4,0,0,0,0,0,0,0,0,0,0,0,7,7,2,2,0,4,4,3,1,5,16,17
122,123,20,21,1,6,1,1,7,5,7,0,5,4,7,2,2,2,2,3,2,7,5,2,4,3,6,5,1,6,7,3,6,1,5,5,4,4,16,17
138,139,16,17,152,153,4,2,152,153,1,5,3,2,7,0,1,3,2,7,7,2,1,5,0,7,3,6,5,2,1,7,6,3,2,1,0,5,18,19
122,123,16,17,5,2,4,6,4,2,152,153,5,3,7,7,4,5,2,2,6,6,1,4,4,88,89,4,3,4,0,2,7,2,0,0,1,3,16,17
138,139,18,19,1,2,5,7,1,5,1,6,152,153,168,7,152,153,4,152,153,20,21,1,168,104,105,169,5,6,4,4,4,3,5,1,2,5,16,17
122,123,16,17,3,5,5,3,0,2,1,1,2,6,0,0,0,0,1,4,2,16,17,88,89,122,123,90,91,0,1,1,3,7,6,5,6,0,18,17
138,139,18,19,7,7,4,7,3,4,4,6,2,4,0,6,0,5,5,6,6,16,17,104,105,138,139,106,107,7,6,2,7,4,1,0,6,4,16,21
124,125,126,127,32,33,34,35,190,191,0,4,1,4,2,0,0,6,0,3,4,125,126,125,126,127,124,125,126,127,48,49,50,51,48,49,50,51,190,191
140,141,142,143,36,37,38,39,206,207,6,4,7,3,2,0,3,0,152,153,2,141,142,141,142,143,140,141,142,143,52,53,54,55,52,53,54,55,206,207
156,157,158,159,40,41,42,43,222,223,7,4,5,120,121,154,155,92,93,94,95,157,158,157,158,159,156,157,158,159,52,53,54,55,52,53,54,55,222,223
172,173,174,175,40,41,42,43,238,239,240,6,168,136,137,170,171,108,109,110,111,173,174,173,174,175,172,173,174,175,59,56,57,59,58,57,59,58,238,239
128,129,130,131,132,133,134,129,130,131,132,133,134,129,130,131,132,133,134,129,130,131,132,133,134,129,130,131,132,133,134,134,129,130,129,130,131,132,133,135
144,145,146,147,148,149,150,150,178,165,178,148,161,179,145,181,177,163,146,166,177,182,178,145,166,181,161,177,162,177,163,180,178,163,165,146,182,148,182,151
160,161,162,163,164,165,166,162,161,182,148,145,145,147,161,163,163,180,165,150,163,147,147,148,182,150,179,149,165,149,178,147,161,164,150,164,146,162,179,167
176,177,178,179,180,181,182,163,147,145,146,179,161,147,161,182,147,165,163,179,162,150,147,177,178,164,148,179,164,145,163,161,165,146,161,163,178,181,146,183
